NO ./textures/text1.xpm
SO ./textures/text2.xpm
WE ./textures/text3.xpm
EA ./textures/text4.xpm

C 25,25,52
F 251,245,220

  111111111111
  100000000001
111100N0011111
10000000001
10000101001
10000101001
11111111111
