NO ./textures/blue_wall.xpm
SO ./textures/yellow_wall.xpm
WE ./textures/red_wall.xpm
EA ./textures/wood_wall.xpm

C 25,25,112
F 245,245,220

11111111111
10000000001
10000000001
10000N00001
10000101001
10000101001
11111111111
