
NO ./textures/neon1.xpm
SO ./textures/neon2.xpm
WE ./textures/neon3.xpm
EA ./textures/neon4.xpm

C 25,25,250
F 251,245,220

  1111111
  1111001N
11111100111
10000000001
10000101001
10000101001
11111111111