NO ./textures/text1.xpm
SO ./textures/text2.xpm
WE ./textures/text3.xpm
EA ./textures/text4.xpm

C 225,30,0
F 220,100,0

11111111111
10000000001
10000000001
10000N00001
10000000001
10000000001
11111111111