
NO ./textures/neon1.xpm
SO ./textures/neon2.xpm
WE ./textures/neon3.xpm
EA ./textures/neon4.xpm

C 102,0,102
F 0,0,5

  1111111
  1111001
11111100111
10000000001
10001001001
100001S1001
10101111111
11101111
10000001
10100001
10000111
11111111