NO ./textures/blue_wall.xpm
SO ./textures/red_wall.xpm
WE ./textures/wood_wall.xpm
EA ./textures/yellow_wall.xpm

C 25,25, 52
F 251,245,220

  111111111111
  100000000001
11110N00011111
10000000001
10000101001
10000101001
11111111111
