
NO ./textures/neon1.xpm
SO ./textures/neon3.xpm
WE ./textures/neon2.xpm
EA ./textures/neon4.xpm

C 102,0,102
F 0,0,5

  1111111
  1111001
11111100111
10000S00001
10001010001
10000101001
11111111111