NO ./textures/blue_wall.xpm
SO ./textures/red_wall.xpm
WE ./textures/wood_wall.xpm
EA ./textures/yellow_wall.xpm

C 25,25,52
F 251,245,220

  111111111111

11110000111111
1000N000001
10000101001
10000101001
11111111111
